LLLLLLLL
LLSLLLLL
LLLLLDDD
LLLLDDDD
LLLDDDLG
LLLLLLLL
